16
16
################
#______________#
#______________#
#__%%______%%__#
#__%%______%%__#
#______________#
#______________#
#______$$______#
#______$$______#
#______________#
#______________#
#__%%______%%__#
#__%%______%%__#
#______________#
#______________#
################